[][][][][][][][]
K0[][][][][][][]
[][][][][][][][]
[][][][][][][][]
B0[][][]P1K1[][]
[][][][][][][][]
[][][][][][][][]
[][][][][][][][]