[][][][][][][][]
[][][][][][][][]
[][][][][][][][]
[][]K0P0[][][]B1
[][][][][][][][]
[][][][][][][][]
[][][][][][][]K1
[][][][][][][][]